HNNNNNBBNBNNNNBNNNBNNBNBNBNNN
NWNWNWBWNWNWBWBWNWNWNWBWBWBWN
NNNBNNNNNBBBNNBNNNNNNBNNNBNBN
NWNWNWNWNWBWNWNWBWBWNWNWNWNWB
PNNNNNNNNNXNBB1NBNNBNN1NNNNN1
NWNWNWNWNWNWNWNWNWBW1WBWNWNWN
BNNBNNNNNNBNNNNNNNNNBNNNNNNNN
NWNWNWNWBWNWNWNWBWBWNWNWNWNWN
BNNNNBBNNBNNNNNNNBNNNNNNNNNNN
NWBWNWNWNWNWNWNWBWNWNWNWNWNWN
NNNNNNNNNNNB1NNBNNBNNNNNNNNNN
